C 50,50,210
NO t.c
R 1200 2147483648
WE t.c
SO t.c
F 144,144,144
EA t.c

111111
1S0101
102001
110001
111111
  1101
