R 1200 1200
NO	file_no.xpm
SO	file_so.xpm
WE	file_we.xpm
EA	file_ea.xpm
F	144,144,144
C	50,50,210

111111
100101
102001
1100N1
111111
