R 1200 2147483648
NO t.c
SO t.c
WE t.c
EA t.c
F 144,144,144
C 50,50,210

111111
100101
102001
1100N1
111111
  1111
